...........
..^..#...^.
...~...~...
...*.*.*...
...~...~...
..^..#...^.
...........
